################################\n
#                              #\n
############# ##################\n
#                              #\n
######################## #######\n
#                              #\n
######################## #######\n
#                              #\n
### ############################\n
#              #               #\n
######## ########## ############\n
#           #                  #\n
####### #################### ###\n
#                    #         #\n
###### ################ ########\n
#                              #\n
################ ###############\n
#                              #\n
#### ###########################\n
#                              #\n
######################### ######\n
#                              #\n
############    t   ############\n
################################\n